#                                                                                          #
# @                                                                                       3#
###     ###################                                                               ##
#  #                #######                                                                #
#   #                  ####                                                                #
#    #                    #                                                               3#
#     #        #   ##  #  #                                                               ##
#      #       ##  ##  ## #                                                                #
#       #                 #                                                                #
#        #                #                                                                #
#         #               #                                                                #
#          #              #                                                                #
#           #             #                                                               3#
#            #            #                                                               ##
#             #           #                                                                #
#              #          #                                                                #
#               #         #                                                                #
#                #        #                                                               3#
#                 #                                                                       ##
#                  #                                                                       #
#                   #                                                                      #
1
999